04 04 04 04 04 04 04 04 04 04 04 04
04 00 00 00 00 00 00 00 00 00 00 04
04 00 00 01 04 04 04 04 04 00 00 04
04 00 01 01 04 05 05 05 04 00 00 04
04 00 04 04 04 05 05 05 04 00 00 04
04 00 04 05 05 05 04 04 04 00 00 04
04 00 04 05 05 05 05 05 04 00 00 04
04 00 04 05 07 05 07 05 04 00 00 04
04 00 04 04 04 04 04 04 04 00 00 04
04 00 00 01 01 01 01 01 00 00 00 04
04 00 00 00 00 00 00 00 00 03 00 04
04 04 04 04 04 04 04 04 04 04 04 04 