03 41 53 65
40
04 04 04 04 04 04 04 04 04 04 04 04
04 00 00 00 00 00 00 00 00 00 00 04
04 00 00 03 03 03 03 03 00 00 00 04
04 00 00 03 05 05 07 03 00 00 00 04
04 00 01 03 05 05 07 03 00 00 00 04
04 00 01 03 03 05 07 03 00 00 00 04
04 00 00 03 05 05 05 03 00 00 00 04
04 00 00 03 05 05 05 03 01 00 00 04
04 00 00 03 03 03 03 03 01 00 00 04
04 00 00 01 01 01 01 01 00 00 00 04
04 00 00 00 00 00 00 00 00 00 00 04
04 04 04 04 04 04 04 04 04 04 04 04 