02 55 78
43
04 04 04 04 04 04 04 04 04 04 04 04
04 00 00 00 00 00 00 00 00 00 00 04
04 00 00 01 00 00 03 03 03 00 00 04
04 03 03 03 03 03 03 05 03 03 00 04
04 03 05 05 05 05 07 07 05 03 00 04
04 03 05 05 05 03 05 05 05 03 00 04
04 03 03 03 03 03 05 03 05 03 00 04
04 00 00 00 01 03 05 05 05 03 00 04
04 00 00 00 01 03 03 03 03 03 00 04
04 00 00 01 01 01 01 01 00 00 00 04
04 00 00 00 00 00 00 00 00 00 00 04
04 04 04 04 04 04 04 04 04 04 04 04 