03 64 65 66
41
04 04 04 04 04 04 04 04 04 04 04 04
04 00 00 00 00 00 00 00 00 00 00 04
04 00 00 03 03 03 03 03 01 00 00 04
04 00 00 03 05 05 05 03 01 00 00 04
04 00 00 03 07 07 07 03 01 00 00 04
04 00 00 03 05 05 05 03 03 00 00 04
04 00 00 03 05 05 05 05 03 00 00 04
04 00 00 03 05 05 05 05 03 00 00 04
04 00 00 03 03 03 03 03 03 00 00 04
04 00 00 01 01 01 01 01 00 00 00 04
04 00 00 00 00 00 00 00 00 00 00 04
04 04 04 04 04 04 04 04 04 04 04 04 