01 54
67
04 04 04 04 04 04 04 04 04 04 04 04
04 00 00 00 00 00 00 00 00 00 00 04
04 00 00 01 03 03 03 03 03 00 00 04
04 00 01 01 03 05 05 05 03 00 00 04
04 00 01 03 03 05 05 05 03 00 00 04
04 00 01 03 05 05 04 05 03 00 00 04
04 00 01 03 05 05 07 05 03 00 00 04
04 00 01 03 05 05 05 05 03 00 00 04
04 00 01 03 03 03 03 03 03 00 00 04
04 00 00 01 01 01 01 01 00 00 00 04
04 00 00 00 00 00 00 00 00 00 00 04
04 04 04 04 04 04 04 04 04 04 04 04