03 53 65 77
79
04 04 04 04 04 04 04 04 04 04 04 04
04 00 00 00 00 00 00 00 00 00 00 04
04 00 03 03 03 03 03 03 03 00 00 04
04 00 03 07 05 03 05 05 03 00 00 04
04 00 03 05 05 05 05 05 03 00 00 04
04 00 03 07 05 05 03 05 03 00 00 04
04 00 03 05 05 05 05 05 03 00 00 04
04 00 03 07 05 03 05 05 03 00 00 04
04 00 03 03 03 03 03 03 03 00 00 04
04 00 00 01 01 01 01 01 00 00 00 04
04 00 00 00 00 00 00 00 00 00 00 04
04 04 04 04 04 04 04 04 04 04 04 04 