01 66
67
04 04 04 04 04 04 04 04 04 04 04 04
04 00 00 00 00 00 00 00 00 00 00 04
04 00 01 01 03 03 03 03 03 00 00 04
04 00 01 01 03 05 05 05 03 00 00 04
04 00 01 01 03 05 03 05 03 00 00 04
04 00 03 03 03 05 05 05 03 00 00 04
04 00 03 05 05 05 03 05 03 00 00 04
04 00 03 05 07 05 05 05 03 00 00 04
04 00 03 05 05 05 03 03 03 00 00 04
04 00 03 03 03 03 03 06 06 00 00 04
04 00 00 00 00 00 00 00 00 00 00 04
04 04 04 04 04 04 04 04 04 04 04 04