01 89
102
04 04 04 04 04 04 04 04 04 04 04 04
04 00 00 00 00 00 00 00 00 00 00 04
04 00 03 03 03 03 03 01 01 01 00 04
04 00 03 05 05 05 03 01 01 01 00 04
04 00 03 05 03 05 03 03 03 00 00 04
04 00 03 05 05 05 07 05 03 00 00 04
04 00 03 03 05 03 03 05 03 00 00 04
04 00 06 03 05 05 05 05 03 00 00 04
04 00 06 03 05 05 05 05 03 00 00 04
04 00 06 03 03 03 03 03 03 00 00 04
04 00 00 00 00 00 00 00 00 00 00 04
04 04 04 04 04 04 04 04 04 04 04 04