02 51 80 
66
04 04 04 04 04 04 04 04 04 04 04 04
04 00 00 00 00 00 00 00 00 00 00 04
04 03 03 03 03 03 00 00 00 00 00 04
04 03 07 03 05 03 01 01 01 01 00 04
04 03 05 05 05 03 03 03 03 03 03 04
04 03 05 05 05 05 05 05 05 05 03 04
04 03 03 03 03 03 03 05 05 05 03 04
04 06 06 06 06 06 03 05 03 07 03 04
04 06 06 06 06 00 03 03 03 03 03 04
04 06 06 00 00 00 01 01 01 01 01 04
04 06 00 00 00 00 00 00 00 00 00 04
04 04 04 04 04 04 04 04 04 04 04 04