02 39 91
51
04 04 04 04 04 04 04 04 04 04 04 04
04 03 03 03 03 03 03 03 03 01 01 04
04 03 05 07 05 05 05 05 03 01 01 04
04 03 05 05 03 05 05 05 03 03 01 04
04 03 05 05 03 03 03 05 05 03 01 04
04 03 03 03 03 05 05 07 05 03 00 04
04 06 00 00 03 05 05 03 05 03 00 04
04 06 06 00 03 05 05 05 05 03 00 04
04 06 06 06 03 05 05 05 05 03 00 04
04 06 06 06 03 03 03 03 03 03 00 04
04 06 06 06 06 06 06 00 00 00 00 04
04 04 04 04 04 04 04 04 04 04 04 04