02 63 64
52
04 04 04 04 04 04 04 04 04 04 04 04
04 00 00 00 06 06 06 06 06 00 01 04
04 00 06 06 06 06 06 06 06 06 00 04
04 06 03 03 03 03 03 03 03 03 06 04
04 06 03 05 05 03 05 05 05 03 01 04
04 00 03 07 05 05 05 05 05 03 00 04
04 00 03 07 05 03 03 03 03 03 00 04
04 01 03 03 03 03 01 01 00 00 00 04
04 01 00 00 00 00 00 00 00 00 01 04
04 01 01 01 00 00 00 00 00 01 01 04
04 01 01 01 01 01 01 01 01 01 01 04
04 04 04 04 04 04 04 04 04 04 04 04