02 78 79
67
04 04 04 04 04 04 04 04 04 04 04 04
04 00 00 00 00 00 00 00 00 00 00 04
04 00 00 00 00 00 00 00 00 00 00 04
04 00 00 00 00 03 03 03 03 00 00 04
04 00 00 00 00 03 05 05 03 00 00 04
04 00 00 03 03 03 07 05 03 00 00 04
04 01 01 03 05 05 05 05 03 01 01 04
04 01 01 03 05 05 05 07 03 01 01 04
04 01 01 03 03 03 03 03 03 01 01 04
04 01 01 01 01 01 01 01 01 01 01 04
04 01 01 01 01 01 01 01 01 01 01 04
04 04 04 04 04 04 04 04 04 04 04 04